111111F1111111
10000000000101
1000F100000101
1010001P100101
10000000000001
10000001101001
11111111111111