F 60, 7, 2
SO ./assets/textures/wall_SO.xpm
WE ./assets/textures/wall_WE.xpm
EA ./assets/textures/wall_EA.xpm
NO ./assets/textures/wall_NO.xpm
C 1, 32, 71

11111
10101
10001
10W01
10001
10001
10001
11111