F 173, 22, 143
SO ./texts/wall22.xpm
WE ./texts/wall22.xpm
EA ./texts/wall22.xpm
C 173, 22, 143





SO1111
111111
100101
101001
1100N1
111111