F 111, 22, 143
SO ./texts/wall22.xpm
WE ./texts/wall22.xpm
EA ./texts/wall22.xpm
NO ./texts/wall22.xpm
C 0, 0, 0

1111111111
1000000101
1000100001
1000W10001
1000100101
1111011001
1111111111