F 111, 22, 143
SO ./texts/wall22.xpm
WE ./texts/wall22.xpm
EA ./texts/wall22.xpm
NO ./texts/wall22.xpm
C 0, 0, 0


11111111111111111111
10001000011000100001
11100110011110011001
10001001011000100101
10110110111011011011
10000100011000010001
11101001011110100101
11111111111111111111