F 111, 22, 143
SO ./texts/wall22.xpm
WE ./texts/wall22.xpm
EA ./texts/wall22.xpm
NO ./texts/wall22.xpm
C 0, 0, 0


11111111111111111111
10010000011000100001
11100110000010011001
1000100101W000100101
10110110001001011011
10000001010000100011
10000001010000100011
11101000010100100101
10110110001001011011
10000001010000100011
11111111111111111111