F 111, 22, 143
SO ./texts/wall22.xpm
WE ./texts/wall22.xpm
EA ./texts/wall22.xpm
NO ./texts/wall22.xpm
C 0, 0, 0

11111111111111111111
10000000000000000001
10111111101111111001
10000000101000000001
10011110101011110001
10010010101010010001
10010010101010010001
10011110101011110001
10000000101111111001
10111111101111111001
10111111101111111001
10000000101000000001
10011110101011110001
10010010101010010001
10010010101010010001
10011110101011110001
1000000010100W000001
10111111101111111001
10000000000000000001
11111111111111111111