F 111, 22, 143
SO ./texts/wall22.xpm
WE ./texts/wall22.xpm
EA ./texts/wall22.xpm
NO ./texts/wall22.xpm
C 0, 0, 0

11111
10001
11111