F 111, 22, 143
SO ./assets/textures/wall_SO.xpm
WE ./assets/textures/wall_WE.xpm
EA ./assets/textures/wall_EA.xpm
NO ./assets/textures/wall_NO.xpm
C 0, 0, 0

111    111                 111
111    101
1011111111
111W000001
1111111111
   1111