F 60, 7, 2
SO ./assets/textures/wall_SO.xpm
WE ./assets/textures/wall_WE.xpm
EA ./assets/textures/wall_EA.xpm
NO ./assets/textures/wall_NO.xpm
C 1, 32, 71

111    111                 111
101    101
1011111101
10000000001111
1000101001
100010001011
1000100100001
101101D11101
100001010001
100001010111
100001010011
100011011000101
100010001
100E1D111111
10000001101
100101000001
11000010000111
10001D11111
1100100001
100011111
1000000011
1111111111
   1111