F 111, 22, 143
SO ./texts/wall22.xpm
WE ./texts/wall22.xpm
EA ./texts/wall22.xpm
NO ./texts/wall22.xpm
C 0, 0, 0

1111111111111111111111111111111111111
1000000000000000100001010101010100001
1010000001000000100001010101010101001
1000000010000000100001010101010100001
1001001010111110100001010000000100001
1001001010100011100001010101010100001
1000001D1001D110000000000000000100001
1000011110000011100000000000010100001
100010000000N000100000000000000000001
1000011110000011110000000000000100001
1001110000000011000001010101010100001
1001001011101110100001010101010100001
1001100111100010100001010101010100001
1001001011111110100001010101010100001
1000000000001001100001010101010100001
1001000000101000100001010101010100001
1111111111111111111111111111111111111