F 60, 7, 2
SO ./assets/textures/wall_SO.xpm
WE ./assets/textures/wall_WE.xpm
EA ./assets/textures/wall_EA.xpm
NO ./assets/textures/wall_NO.xpm
C 1, 32, 71

111    111                 111
101    101
1011111101
10000000001111
1000001001
100001101011
1000011100001
101111111101
100001000001
100001010111
100001010011
100001D101
1000100001
100001N01111
10000001101
100000001
1100000111111
10000110001
1100100001
1000010001
1000000011
1111111111
   1111