F 60, 7, 2
SO ./assets/textures/wall_SO.xpm
WE ./assets/textures/wall_WE.xpm
EA ./assets/textures/wall_EA.xpm
NO ./assets/textures/wall_NO.xpm
C 1, 32, 71

111    111                 111
1N1    101
1011111101
1000000001
100000001
1000000001
1000000001
100000001
100000001
100000001
100000001
1111111111
   1111