F 60, 7, 2
SO ./assets/textures/wall_SO.xpm
WE ./assets/textures/wall_WE.xpm
EA ./assets/textures/wall_EA.xpm
NO ./assets/textures/wall_NO.xpm
C 1, 32, 71

111    111                 111
101    101
1011111101
10000000001
1000101001
100010001011
10001001001
10110111101
100101E00001
110000100011
1000111111
110010001
100011111
1000000011
1111111111