F 111, 22, 143
SO ./texts/wall22.xpm
WE ./texts/wall22.xpm
EA ./texts/wall22.xpm
NO ./texts/wall22.xpm
C 0, 0, 0

11111111111111111111
10000000000000000001
10100000010000001001
1000000010N000000001
10010010101010000001
10010010100010010001
10010010101010000001
11111111111111111111